sample_FLLGDB1.fq_align	FLLG
sample_FLLGDB2.fq_align	FLLG
sample_FLLGDB3.fq_align	FLLG
sample_FLLGDB4.fq_align	FLLG
sample_FLLGDB5.fq_align	FLLG
sample_FLLGF01.fq_align	FLLG
sample_FLLGF02.fq_align	FLLG
sample_FLLGF03.fq_align	FLLG
sample_FLLGF04.fq_align	FLLG
sample_FLLGF05.fq_align	FLLG
sample_FLLGF06.fq_align	FLLG
sample_FLLGF07.fq_align	FLLG
sample_FLLGF08.fq_align	FLLG
sample_FLLGF09.fq_align	FLLG
sample_FLLGF10.fq_align	FLLG
sample_FLLGF11.fq_align	FLLG
sample_FLLGF12.fq_align	FLLG
sample_FLLGF13.fq_align	FLLG
sample_FLLGF14.fq_align	FLLG
sample_FLLGF15.fq_align	FLLG
sample_FLLGF16.fq_align	FLLG
sample_FLLGF17.fq_align	FLLG
sample_FLLGJA.fq_align	FLLG
sample_FLLGJB.fq_align	FLLG
sample_FLLGJC.fq_align	FLLG
sample_FLLGJD.fq_align	FLLG
sample_FLLGJE.fq_align	FLLG
sample_FLLGJF.fq_align	FLLG
sample_FLLGJG.fq_align	FLLG
sample_FLLGJH.fq_align	FLLG
sample_FLLGJI.fq_align	FLLG
sample_FLLGJJ.fq_align	FLLG
sample_FLLGJK.fq_align	FLLG
sample_FLLGJL.fq_align	FLLG
sample_FLLGJM.fq_align	FLLG
sample_FLLGJN.fq_align	FLLG
sample_FLLGJO.fq_align	FLLG
sample_FLLGJP.fq_align	FLLG
sample_FLLGJQ.fq_align	FLLG
sample_FLLGJR.fq_align	FLLG
sample_FLLGJS.fq_align	FLLG
sample_FLLGJT.fq_align	FLLG
sample_FLLGJU.fq_align	FLLG
sample_FLLGJV.fq_align	FLLG
sample_FLLGNP1.fq_align	FLLG
sample_FLLGNP2.fq_align	FLLG
sample_FLLGNP3.fq_align	FLLG
sample_FLLGNP4.fq_align	FLLG
sample_LAFWDB1.fq_align	LAFW
sample_LAFWDB2.fq_align	LAFW
sample_LAFWDB3.fq_align	LAFW
sample_LAFWDB4.fq_align	LAFW
sample_LAFWF01.fq_align	LAFW
sample_LAFWF02.fq_align	LAFW
sample_LAFWF03.fq_align	LAFW
sample_LAFWF04.fq_align	LAFW
sample_LAFWF05.fq_align	LAFW
sample_LAFWF06.fq_align	LAFW
sample_LAFWF07.fq_align	LAFW
sample_LAFWF08.fq_align	LAFW
sample_LAFWF09.fq_align	LAFW
sample_LAFWNP01.fq_align	LAFW
sample_LAFWNP02.fq_align	LAFW
sample_LAFWNP03.fq_align	LAFW
sample_LAFWNP04.fq_align	LAFW
sample_LAFWNP05.fq_align	LAFW
sample_LAFWNP06.fq_align	LAFW
sample_LAFWNP07.fq_align	LAFW
sample_LAFWNP08.fq_align	LAFW
sample_LAFWNP09.fq_align	LAFW
sample_LAFWNP10.fq_align	LAFW
sample_LAFWP01.fq_align	LAFW
sample_LAFWP02.fq_align	LAFW
sample_LAFWP03.fq_align	LAFW
sample_LAFWP04.fq_align	LAFW
sample_LAFWP05.fq_align	LAFW
sample_LAFWP06.fq_align	LAFW
sample_LAFWP07.fq_align	LAFW
sample_LAFWP08.fq_align	LAFW
sample_LAFWP09.fq_align	LAFW
sample_LAFWP10.fq_align	LAFW
sample_LAFWP11.fq_align	LAFW
sample_LAFWP12.fq_align	LAFW
sample_LAFWP13.fq_align	LAFW
sample_LAFWP14.fq_align	LAFW
sample_LAFWP15.fq_align	LAFW
sample_LAFWP16.fq_align	LAFW
sample_LAFWP17.fq_align	LAFW
sample_LAFWP18.fq_align	LAFW
sample_LAFWP19.fq_align	LAFW
sample_LAFWP20.fq_align	LAFW
sample_LAFWP21.fq_align	LAFW
sample_LAFWP22.fq_align	LAFW
sample_LAFWP23.fq_align	LAFW
sample_LAFWP24.fq_align	LAFW
sample_LAFWP26.fq_align	LAFW
sample_ALFWF01.fq_align	ALFW
sample_ALFWF02.fq_align	ALFW
sample_ALFWF03.fq_align	ALFW
sample_ALFWF04.fq_align	ALFW
sample_ALFWF05.fq_align	ALFW
sample_ALFWF06.fq_align	ALFW
sample_ALFWF07.fq_align	ALFW
sample_ALFWF08.fq_align	ALFW
sample_ALFWF09.fq_align	ALFW
sample_ALFWF10.fq_align	ALFW
sample_ALFWF11.fq_align	ALFW
sample_ALFWF12.fq_align	ALFW
sample_ALFWF13.fq_align	ALFW
sample_ALFWF14.fq_align	ALFW
sample_ALFWF15.fq_align	ALFW
sample_ALFWF16.fq_align	ALFW
sample_ALFWF17.fq_align	ALFW
sample_ALFWF18.fq_align	ALFW
sample_ALFWF19.fq_align	ALFW
sample_ALFWF20.fq_align	ALFW
sample_ALFWF21.fq_align	ALFW
sample_ALFWNP11.fq_align	ALFW
sample_ALFWNP1.fq_align	ALFW
sample_ALFWNP2.fq_align	ALFW
sample_ALFWNP3.fq_align	ALFW
sample_ALFWP01.fq_align	ALFW
sample_ALFWP02.fq_align	ALFW
sample_ALFWP03.fq_align	ALFW
sample_ALFWP04.fq_align	ALFW
sample_ALFWP05.fq_align	ALFW
sample_ALFWP06.fq_align	ALFW
sample_ALFWP07.fq_align	ALFW
sample_ALFWP09.fq_align	ALFW
sample_ALFWP10.fq_align	ALFW
sample_ALFWP11.fq_align	ALFW
sample_ALFWP12.fq_align	ALFW
sample_ALFWP13.fq_align	ALFW
sample_ALFWP14.fq_align	ALFW
sample_ALFWP15.fq_align	ALFW
sample_ALFWP16.fq_align	ALFW
sample_ALFWP17.fq_align	ALFW
sample_ALFWP18.fq_align	ALFW
sample_ALFWP19.fq_align	ALFW
sample_ALFWP20.fq_align	ALFW
sample_ALFWP21.fq_align	ALFW
sample_ALFWP22.fq_align	ALFW
sample_ALFWP23.fq_align	ALFW
sample_ALFWP24.fq_align	ALFW
sample_TXFWDB1.fq_align	TXFW
sample_TXFWF01.fq_align	TXFW
sample_TXFWF02.fq_align	TXFW
sample_TXFWF03.fq_align	TXFW
sample_TXFWF04.fq_align	TXFW
sample_TXFWF05.fq_align	TXFW
sample_TXFWJ02.fq_align	TXFW
sample_TXFWJ03.fq_align	TXFW
sample_TXFWJ04.fq_align	TXFW
sample_TXFWJ05.fq_align	TXFW
sample_TXFWJ06.fq_align	TXFW
sample_TXFWJ07.fq_align	TXFW
sample_TXFWJ08.fq_align	TXFW
sample_TXFWJ09.fq_align	TXFW
sample_TXFWJ10.fq_align	TXFW
sample_TXFWJ11.fq_align	TXFW
sample_TXFWJ12.fq_align	TXFW
sample_TXFWJ13.fq_align	TXFW
sample_TXFWJ14.fq_align	TXFW
sample_TXFWJ15.fq_align	TXFW
sample_TXFWJ16.fq_align	TXFW
sample_TXFWJ18.fq_align	TXFW
sample_TXFWJ19.fq_align	TXFW
sample_TXFWJ20.fq_align	TXFW
sample_TXFWJ21.fq_align	TXFW
sample_TXFWJ22.fq_align	TXFW
sample_TXFWNP2.fq_align	TXFW
sample_TXFWNP3.fq_align	TXFW
sample_TXFWNP4.fq_align	TXFW
sample_TXFWNP5.fq_align	TXFW
sample_TXFWP01.fq_align	TXFW

